F 76,76,76
C 99,99,99

NO assets/textures/north.png
SO assets/textures/south.png
WE assets/textures/west.png
EA assets/textures/east.png

1111111111111111111
10W0001001001000001
1000000001000001001
1001010001111101111
1000101000001001001
1000000001000001001
1001011010101001001
1000100000000001011
1000000001000000001
1111111111111111111
