NO assets/textures/north.png
SO assets/textures/south.png
WE assets/textures/west.png
EA assets/textures/east.png

F 164,169,20
C 88,66,99

111111111111111111111
100000000000000000001
100000001000100000001
10000E00D000010000001
100000001101100000001
10000000D000000000001
111111111111111111111

