NO assets/textures/north.png
SO assets/textures/south.png
WE assets/textures/west.png
EA assets/textures/east.png

F 20,20,20
C 200,200,200

11111
10001
10N01
10001
11111

