NO assets/textures/north.png
SO assets/textures/south.png
WE assets/textures/west.png
EA assets/textures/east.png

F 220,100,0
C 225,30,0

        1111111111111111111111111
        1000000000110000000000001
        1011000001100000000000001
        1001000000000000000000001
111111111011000001110000000000001
100000000011000001110111111111111
11110111101111011100000000001
11110111101111011101000000001
11000000110101011100000100001
10000000000000001100001010001
10000000000000001101000000001
11000001110101011111000000N0111
11110111 1110101 101111010001
11111111 1111111 111111111111
