NO assets/textures/test/north.png
SO assets/textures/test/south.png
WE assets/textures/test/west.png
EA assets/textures/test/east.png

C 35,19,73
F 15,6,40

111111111111111       111111111111111
111111000111111       111111000111111
111110000011111       111110000011111
1111000N0001111       111100000001111
111000000000111       111000000000111
1100000000000111111111110000000000011
1000011111000000000000000001111100001
1100001110000111111111110000111000011
111000010000111       111000010000111
111100000001111       111100000001111
111110000011111       111110000011111
111111000111111       111111000111111
111111111111111       111111111111111

